9 16
|--------------|
|FFF|...-......|
|....P.........|
|FF...@|..P....|
|......|.......|
|......|---|...|
|........P.|...|
|.P.....---|...|
|--------------|